NO        ./xpm/ken1.xpm
SO          ./xpm/ken2.xpm
WE ./xpm/js.xpm
EA ./xpm/touka.xpm

F 220,100,0
C 225,30,0

        111111111111111111111111111111111111
        100000000011000000000000000000000001
        101100000111000000000000000000000001
        1001000000000000000000000000000000011
11111111101100000010000000000000000000000011
10000000001100000111011111111111000000000001
11110111111111011100000010000000000000011111
1111011111111101110101001000000000000001
110000001101010111000N001000000000000001
1000000000000000110000001000000000000001
10000000000000001101010000000000000000011
11000001110101011111011110011000000000001
11110111 1110101 101111010000000000000011
11111111 1111111 11111111111111111111111