NO        ./xpm/ken1.xpm
SO          ./xpm/ken2.xpm
WE ./xpm/js.xpm
EA ./xpm/touka.xpm

C 25, 25, 35
F 57, 125, 220

    11111111111    1111111111111111111111111111111111111111111  1
111111100000001    1000000011100000000000000100000000000000111  11111
   111100000001    10000000111000000000000001000000000000000111  11
   111100000001    1000000011100000000000000100000000000000111  11
111111100000001    1000000011100000000000000000000000000000111  11
111111100000001    1000000011100000000000000100000000000000111  11
111111100000001    1000000011100000000000000100000000000000111  11
111111100000001    10000000111000000000000001000000000000001111111
111111100000001    100000001111000000000000011111111111111111111111
1     100000001111110000000000000000000000001000000000000001000001
1     1000000000000000100000000000000000000000000000000000010000011
1     1000000000000001110000000000000000000000000000000000001000001
1     1000000000000000100000000000000000000000000000000000010000011
1     100000000000000000010000000000000000000000000000000011000011
1     10000000000000000000001100000000000010000000000000010000111
1     111111111111111111111111111111111111111111111111111111111111
1          1                        1
111111111111                      111
100000000001               111111111111111111111111111111
100000000001                        1
1111111111111111111111111111111111111
